##########
#@.......#
#........#
#...B....#
#........#
#.......*#
##########