##########
#@.......#
#........#
#...B....#
#........#
#.B*....*#
##########