##########
#........#
#...B....#
#..@...*.#
#....B...#
#.......*#
##########