###############
#.*....#......#
#..BB..#..*...#
#.*.#B.#..#...#
#...#..B..#...#
#..#..#...#...#
#.@..B..*.##..#
#...##..B..*..#
#...*....#....#
###############