########
#..B.*.#
#...*..#
#.B.B.@#
#*.....#
########